1111111111111111
110E0000000C0011
1100000000001111
1100000000M00P01
1100000000M00001
1111111111111111