1111111111111111111111111111111111
1100000000000000000001000010000001
1P10000000000000000000000MCM100001
10000000000000000000000000C1000001
1000000C000CCCCCCCCCC00C000000MEM1
1000C00000000000000000000000000001
1111111111111111111111111111111111