1111111111111111
110E0000001C0011
1111000000001111
11000000M0M00001
11000000PM000001
1111111111111111