1111111111111111111111111111111111
101000000000000C00000C000000000001
1110010100100000101M01000M0M010111
1010010010101010001001000M00010101
1P00000M0C00C0M000000M000M000000C1
1111111111111111111111111111111111