111111111111111111111111111111111111
111111111111111111111111111111110001
110000000000000C00000C0000000M000111
1EC00101101000001010M10000000M010111
11100100101010100010CM0000000M0M0111
100000000M00C1001000M0000P000M0MC111
100M0000MC0MC000000000000000000MC111
111111111111111111111111111111111111