1111111111111111111111111111111111
10P1000000000000000000000000000001
10100000000000000000000000C0000001
1010000000000000000000000000000001
10100C0000000000000000000000000001
1000000000000000000000000000000001
1000000000000000000000000000000001
1000000001000000000000000000000001
100000000C100000000000000000000001
1000000001000000000000000000000001
1000000000000000000000000000000001
1000000000000000000000000000000001
1000000000000000000C00000000000001
1000000000000000000000000000000001
1000000000000000000000000000010001
10000000000000000000000000001CM101
1000000000000000000000000000000101
1000000C00000000000000000000001E01
1000000000000000000000000000001001
1111111111111111111111111111111111
